####################################
# S#  #          #     #          E#
#  #  #  ######  #        #  #######
#  #                #     #        #
#  #                #     #        # 
#  ####  #########  ####  ## ## #  #
#  ####  #########  ####  ## ## #  #
#  #     #       #        #     #  #
#  #     #  ###  ######   #  #  #  #
#     #  #  # #       #      #  #  #
#     #  #  # #       #      #  #  #
####################################
