####################################
#S #  #                           E#
#  #  #                      #######
#  #                               #
#  ####                    # ## #  #
#  #                            #  #
#  #  #                      #  #  #
#     #                      #  #  #
#     #                      #  #  #
####################################
