####################################
#S                                E#
#                            #######
#                                  #
#                          # ## #  #
#                               #  #
#                            #  #  #
#                            #  #  #
#                            #  #  #
####################################
