####################################
#S #  #          #     #          E#
#  #  #  ######  #        #  #######
#  #                #     #        #
#  ####  #########  ####  ## ## #  #
#  #     #       #        #     #  #
#  #  #  #  ###  ######   #  #  #  #
#     #  #  # #       #      #  #  #
#     #  #  # #       #      #  #  #
####################################
